10 10
##########
#.#...#.*#
#.#...#..#
#..#.....#
#....###.#
#....#...#
#..#...#.#
#.###.##.#
#$......##
##########
